"(???) -"	(titel)
"(???) Alien"	(titel)
"(???) Alien vs. Predator"	(titel)
"(???) Anno"	(titel)
"(???) Assassin's Creed"	(titel)
"(???) Assassin's Creed 4: Unity"	(titel)
"(???) Avatar"	(titel)
"(???) BF23"	(titel)
"(???) Baldur's Gate 1+2"	(titel)
"(???) Bat man"	(titel)
"(???) Batman"	(titel)
"(???) Battlefield"	(titel)
"(???) Battlefield 3/4"	(titel)
"(???) Battlefield: Modern Warfacre"	(titel)
"(???) Bayonetta 1+2"	(titel)
"(???) Bioshock 1&2"	(titel)
"(???) BlazBlue (alle Spielereihe)"	(titel)
"(???) C&C alle Teile"	(titel)
"(???) Call of Duty Advanced Warfigher"	(titel)
"(???) Call of Duty diverse"	(titel)
"(???) Civilization"	(titel)
"(???) Colin Mcrae rally"	(titel)
"(???) Dark Souls 1+2"	(titel)
"(???) Deponia 1-3"	(titel)
"(???) Deponia (Teil 2 & 3 )"	(titel)
"(???) Deponia-Serie"	(titel)
"(???) Die Sims 2 / 3"	(titel)
"(???) Dirt Sc"	(titel)
"(???) Divinity"	(titel)
"(???) Doto.2"	(titel)
"(???) Downhill Racing"	(titel)
"(???) Dragon Age 1 - 3"	(titel)
"(???) Dragon Age 1+3"	(titel)
"(???) Dragon Age Series"	(titel)
"(???) Dragon Age alle Teile"	(titel)
"(???) Dragon AgeO"	(titel)
"(???) Dragon Agentur 3"	(titel)
"(???) Duolingo"	(titel)
"(???) EA UFC Undisputed"	(titel)
"(???) Evoker"	(titel)
"(???) F.E.A.R. 1, 2 & 3"	(titel)
"(???) Family Guy"	(titel)
"(???) Family Guy (Android)"	(titel)
"(???) Far Cry 3/4"	(titel)
"(???) Far Cry Reihe"	(titel)
"(???) Farcry alle Teile"	(titel)
"(???) Farming Simulator"	(titel)
"(???) Fifa"	(titel)
"(???) Flash spiele auf kongregate.com und armorgames.com"	(titel)
"(???) Football Manager"	(titel)
"(???) Forza"	(titel)
"(???) Forza Motorsport"	(titel)
"(???) Fußball Manager"	(titel)
"(???) Genius Unternehmen Physik"	(titel)
"(???) Genre: RTS"	(titel)
"(???) Genre: Shmups"	(titel)
"(???) God Of War 1+3"	(titel)
"(???) Gran Turismo"	(titel)
"(???) Halo 1-4"	(titel)
"(???) Hugo"	(titel)
"(???) Ich hasse Frauen"	(titel)
"(???) Jurassic Park"	(titel)
"(???) Just Dance"	(titel)
"(???) Knights of the old Republic 1+2"	(titel)
"(???) Kotor 1 & 2"	(titel)
"(???) LS Simulator 2013"	(titel)
"(???) Landwirtschaft Simulator"	(titel)
"(???) Landwirtschafts -Simulator"	(titel)
"(???) Landwirtschaftssimulator"	(titel)
"(???) Lanwirtschaftssimulator"	(titel)
"(???) Lasers"	(titel)
"(???) Lego Harry Potter 5-7"	(titel)
"(???) M.A.X."	(titel)
"(???) Madden"	(titel)
"(???) Magna Carta"	(titel)
"(???) Mario"	(titel)
"(???) Mario Kart"	(titel)
"(???) Mario Party"	(titel)
"(???) Marvell Heroes"	(titel)
"(???) Mass Effect 2+3"	(titel)
"(???) Mass Effect Reihe"	(titel)
"(???) Mass Effect Trilogy"	(titel)
"(???) Mass effect 1,2,3"	(titel)
"(???) Massefect 1+2"	(titel)
"(???) Max"	(titel)
"(???) Metal Gear Solid HD Collection"	(titel)
"(???) Metro"	(titel)
"(???) Metroid Prime"	(titel)
"(???) Middle-earth"	(titel)
"(???) Nhl"	(titel)
"(???) Omnibus 2"	(titel)
"(???) PacMan"	(titel)
"(???) PanzerGeneral"	(titel)
"(???) Picross"	(titel)
"(???) Pirates"	(titel)
"(???) Pokémon"	(titel)
"(???) Portal 1/2"	(titel)
"(???) Postal"	(titel)
"(???) Pro Evolution Soccer"	(titel)
"(???) Pro Evolution Soccer 200x"	(titel)
"(???) Prof layton"	(titel)
"(???) Professor Layton"	(titel)
"(???) Professor Layton Reihe"	(titel)
"(???) Professor Layton und die Maske des Schicksals"	(titel)
"(???) Ratchet & Clank"	(titel)
"(???) Rayman"	(titel)
"(???) Runaway 1-3"	(titel)
"(???) SC:BL"	(titel)
"(???) SPIDERMAN"	(titel)
"(???) SSB"	(titel)
"(???) SW: KoToR 1 /2"	(titel)
"(???) Schach"	(titel)
"(???) Scooby Doo"	(titel)
"(???) Siedler"	(titel)
"(???) Silent Hill"	(titel)
"(???) SimCity"	(titel)
"(???) Simpsons"	(titel)
"(???) Simsons"	(titel)
"(???) Skylanders"	(titel)
"(???) Smash Bros. Brawl for Wii U"	(titel)
"(???) Sniper Elite 3 + die 2 Zombie-Army Teile"	(titel)
"(???) South Park"	(titel)
"(???) Southpark"	(titel)
"(???) Star Wars"	(titel)
"(???) StarCraft II inkl. BroodWar"	(titel)
"(???) StarCraft III"	(titel)
"(???) Sudoku"	(titel)
"(???) Super Mario Bros."	(titel)
"(???) Super Smash Bros."	(titel)
"(???) Tentacle Girl"	(titel)
"(???) Tentacle Wars"	(titel)
"(???) The Chronicles of Riddick"	(titel)
"(???) The Elder Scrolls: Oblivion/Skyrim"	(titel)
"(???) The Endless"	(titel)
"(???) The GReat Giana Sisters Twisted Dreams"	(titel)
"(???) The Legend of Zelda"	(titel)
"(???) The tribes & castles"	(titel)
"(???) Thief 1-3"	(titel)
"(???) Titan"	(titel)
"(???) Tomb Raider - Alle Teile"	(titel)
"(???) Tomb Raider 1 + 2"	(titel)
"(???) Tome"	(titel)
"(???) Total War"	(titel)
"(???) Total War (Spielereihe)"	(titel)
"(???) Trials"	(titel)
"(???) Trine 1+2"	(titel)
"(???) Uncharted"	(titel)
"(???) Unchartet 1-3"	(titel)
"(???) Wice star"	(titel)
"(???) Wing Commander"	(titel)
"(???) Wipe Out"	(titel)
"(???) Worms 3"	(titel)
"(???) X:COM"	(titel)
"(???) X-Com"	(titel)
"(???) X-Plane"	(titel)
"(???) andrere"	(titel)
"(???) civ 6"	(titel)
"(???) diverse iPhone"	(titel)
"(???) empire"	(titel)
"(???) etliche Smartphone-Spiele"	(titel)
"(???) fifa 14/15"	(titel)
"(???) naruto shippuden ultimate ninja storm"	(titel)
"(???) naruto ultimate ninja storm"	(titel)
"(???) oculus rift demos"	(titel)
"(???) phoenix Wright Reihe"	(titel)
"(???) price grab"	(titel)
"(???) simpsons spiel fuer android"	(titel)
"(???) ufc"	(titel)
"(???) viele Indie-Puzzle/Adventure-Spiele"	(titel)
"0 A.D."	(titel)
"0h h1"	(titel)
"100% Orange Juice"	(titel)
"10000000"	10000000
"2048"	(titel)
"3 Gewinnt (Big Fish)"	(titel)
"4 Bilder ein Wort"	(titel)
"7 Days to Die"	(titel)
"8 Ball Pool Billard"	(titel)
"80 days"	(titel)
"A Bird Story"	(titel)
"A Game of Dwarves"	(titel)
"A New Beginning"	"A New Beginning"
"A1"	(titel)
"APB: Reloaded"	(titel)
"AVA - Alliance of Valiant Arms"	(titel)
"AaaaaAAaaaAAAaaAAAAaAAAAA!!! for the Awesome"	(titel)
"Aarklash: Legacy"	(titel)
"Academagia: The Making of Mages"	(titel)
"Ace Combat 6: Fires of Liberation"	"Ace Combat 6: Fires of Liberation"
"Ace Combat: Infinity"	(titel)
"Ace of Spades"	(titel)
"Act of War: Direct Action"	"Act of War: Direct Action"
"Action Henk"	(titel)
"Advance Wars: Dual Strike"	"Advance Wars: Dual Strike"
"Adventure Town"	(titel)
"Age Of Wonders"	"Age of Wonders"
"Age of Chivalry"	(titel)
"Age of Conan"	(titel)
"Age of Empires"	"Age of Empires"
"Age of Empires: Castle Siege"	(titel)
"Age of Empires II HD"	(titel)
"Age of Empires II: The Age of Kings"	"Age of Empires II: The Age of Kings"
"Age of Empires III"	"Age of Empires III"
"Age of Mythology"	"Age of Mythology"
"Age of Mythology (Extended Edition)"	(titel)
"Age of Wonders II: Der Zirkel der Zauberer"	"Age of Wonders II: Der Zirkel der Zauberer"
"Age of Wonders III"	(titel)
"Aion"	Aion
"Airline Tycoon"	"Airline Tycoon"
"Airline Tycoon 2"	"Airline Tycoon 2"
"Alan Wake"	"Alan Wake"
"Alan Wake's American Nightmare"	"Alan Wake's American Nightmare"
"Alarm für Cobra 11: Das Syndikat"	"Alarm für Cobra 11: Das Syndikat"
"Alice: Madness Returns"	"Alice: Madness Returns"
"Alien  Isolation"	(titel)
"Alien Hive"	(titel)
"Alien: Isolation"	"Alien: Isolation"
"Alien Rage: Unlimited"	(titel)
"Alien Swarm"	"Alien Swarm"
"Aliens: Colonial Marines"	"Aliens: Colonial Marines"
"Aliens vs Predators (2010)"	(titel)
"Alpha Protocol"	"Alpha Protocol"
"Altitude"	(titel)
"Alundra"	Alundra
"Always Sometimes Monsters"	(titel)
"Amazing Alex"	(titel)
"Amazing Ninja"	(titel)
"Amnesia: A Machine for Pigs"	(titel)
"Amnesia: The Dark Descent"	"Amnesia: The Dark Descent"
"Anarchy Online"	"Anarchy Online"
"Anarchy Reigns"	"Anarchy Reigns"
"Angry Birds"	"Angry Birds"
"Angry Birds Rio"	"Angry Birds Rio"
"Angry Birds: Star Wars"	"Angry Birds: Star Wars"
"Angry Birds Transformers"	(titel)
"Animal Crossing: New Leaf"	"Animal Crossing: New Leaf"
"Anno 1404"	"Anno 1404"
"Anno 1503"	"Anno 1503"
"Anno 1602"	(titel)
"Anno 1701"	"Anno 1701"
"Anno 2070"	"Anno 2070"
"Anno Online"	(titel)
"Anstoss 3"	"Anstoss 3"
"Antichamber"	(titel)
"Anvil of Dawn"	"Anvil of Dawn"
"Aquanox 2"	(titel)
"Ar nosurge: Ode to an Unborn Star"	"Ar nosurge: Ode to an Unborn Star"
"Arcana Heart 3: LOVE MAX!!!!!"	(titel)
"Arcania: Gothic 4"	"ArcaniA: Gothic 4"
"Arcanum: Von Dampfmaschinen und Magie"	"Arcanum: Von Dampfmaschinen und Magie"
"ArcheAge"	(titel)
"ArcheBlade"	(titel)
"Arena : Cyber Evolution"	(titel)
"ArmA 2"	(titel)
"ArmA 3"	(titel)
"ArmA: Armed Assault"	"ArmA: Armed Assault"
"Armed Assault 3‎"	(titel)
"Armies of Exigo"	"Armies of Exigo"
"Army of Darkness: Defense"	(titel)
"Army of Two"	"Army of Two"
"Art of Balance"	"Art of Balance"
"Asphalt 8: Airborne"	(titel)
"Assassins  Creed Black Flag"	(titel)
"Assassins  Creed Unity"	(titel)
"Assassin's Creed  Unity"	(titel)
"Assassin's Creed (1)"	(titel)
"Assassin's Creed: Brotherhood"	"Assassin's Creed: Brotherhood"
"Assassin's Creed II"	"Assassin's Creed II"
"Assassin's Creed III"	"Assassin's Creed III"
"Assassin's Creed IV: Black Flag"	"Assassin's Creed IV: Black Flag"
"Assassin's Creed: Revelations"	"Assassin's Creed: Revelations"
"Assassin's Creed Rogue"	(titel)
"Assassin's Creed: Unity"	"Assassin's Creed: Unity"
"Assetto Corsa"	(titel)
"Audiosurf 2"	(titel)
"Audiosurf: Ride Your Music"	"Audiosurf: Ride Your Music"
"Aura Kingdom"	(titel)
"Awesomenauts"	Awesomenauts
"Azkend"	(titel)
"BIT.TRIP RUNNER"	"Bit.Trip Runner"
"Back to the Future: The Game"	(titel)
"Bad Piggies"	(titel)
"Badland (2013)"	(titel)
"Baldur's Gate"	"Baldur's Gate"
"Baldur's Gate 2: Schatten von Amn"	(titel)
"Baldur's Gate: Enhanced Edition"	(titel)
"Bang Bang Racing"	"Bang Bang Racing"
"Banished"	(titel)
"Banner Saga"	(titel)
"Baphomets Fluch (1996)"	(titel)
"Baphomets Fluch: Der Sündenfall"	(titel)
"Bastion"	Bastion
"Batman: Arkham Asylum"	"Batman: Arkham Asylum"
"Batman: Arkham City"	"Batman: Arkham City"
"Batman: Arkham Knight"	(titel)
"Batman: Arkham Origins"	"Batman: Arkham Origins"
"Battle Island"	(titel)
"Battle Realms"	"Battle Realms"
"BattleBlock Theater"	"BattleBlock Theater"
"Battlefield  4"	(titel)
"Battlefield 1942"	"Battlefield 1942"
"Battlefield 2"	"Battlefield 2"
"Battlefield 3"	"Battlefield 3"
"Battlefield 4"	"Battlefield 4"
"Battlefield 4/Final  Stand"	(titel)
"Battlefield: Bad Company"	"Battlefield: Bad Company"
"Battlefield: Bad Company 2"	"Battlefield: Bad Company 2"
"Battlefield Heroes"	(titel)
"Battlefield Play4Free"	(titel)
"Bayonetta"	Bayonetta
"Bayonetta 2"	"Bayonetta 2"
"BeamNG.drive"	BeamNG.drive
"Beasts of Prey"	(titel)
"Beat Hazard"	"Beat Hazard"
"Bedlam"	Bedlam
"Bejeweled"	Bejeweled
"Bejeweled 3"	"Bejeweled 3"
"Bernd Das Brot Und Die Unmöglichen"	(titel)
"Betrayer"	(titel)
"Beyond Good & Evil"	"Beyond Good & Evil"
"Beyond: Two Souls"	"Beyond: Two Souls"
"Bike Rivals"	(titel)
"BioShock 2"	"BioShock 2"
"BioShock Infinite"	"BioShock Infinite"
"Biohazard rebirth"	(titel)
"Bioshock"	BioShock
"Bit.Trip.Runner"	(titel)
"Bit.Trip.Runner 2"	(titel)
"Black & White 2"	"Black & White 2"
"Blacklight Retribution"	(titel)
"Blackshot"	(titel)
"Blackwell Unbound"	"Blackwell Unbound"
"Bladestorm: Der Hundertjährige Krieg"	"Bladestorm: Der Hundertjährige Krieg"
"Bleach - Soul Resurreccion"	(titel)
"Blendoku"	(titel)
"Blitz Brigade"	(titel)
"Blobby Volley"	(titel)
"Blobby Volley 2"	(titel)
"Blockstorm"	(titel)
"Blood 2"	(titel)
"Blood Bowl"	"Blood Bowl"
"BloodRayne"	BloodRayne
"Bloons Tower Defense 5"	(titel)
"Blur"	Blur
"Book  of unwritten Tales"	(titel)
"Boom Beach"	(titel)
"Borderlands"	Borderlands
"Borderlands  The Pre- Sequel"	(titel)
"Borderlands 2"	"Borderlands 2"
"Borderlands: The Pre-Sequel"	(titel)
"Boulder Dash"	"Boulder Dash"
"Braid"	Braid
"Brave and Default"	(titel)
"Braveland"	(titel)
"Bravely Default"	"Bravely Default"
"Brink"	Brink
"Broforce"	(titel)
"Broken Age"	(titel)
"Brothers: A Tale of Two Sons"	"Brothers: A Tale of Two Sons"
"Brütal Legend"	"Brütal Legend"
"Bubble Witch 2 Saga"	(titel)
"Bulletstorm"	Bulletstorm
"Bully: Scholarship Edition"	"Bully: Scholarship Edition"
"Burnout Paradise"	(titel)
"CSI: Hidden Crimes"	(titel)
"Caesar III"	"Caesar III"
"Call of Duty"	"Call of Duty"
"Call of Duty 2"	"Call of Duty 2"
"Call of Duty 3"	"Call of Duty 3"
"Call of Duty 4: Modern Warfare"	"Call of Duty 4: Modern Warfare"
"Call of Duty: Advanced Warfare"	"Call of Duty: Advanced Warfare"
"Call of Duty: Black Ops"	"Call of Duty: Black Ops"
"Call of Duty: Black Ops II"	"Call of Duty: Black Ops II"
"Call of Duty: Ghosts"	"Call of Duty: Ghosts"
"Call of Duty: Modern Warfare 2"	"Call of Duty: Modern Warfare 2"
"Call of Duty: Modern Warfare 3"	"Call of Duty: Modern Warfare 3"
"Call of Duty: World at War"	"Call of Duty: World at War"
"Call of Juarez"	"Call of Juarez"
"Candy Crush"	(titel)
"Candy Crush Saga"	(titel)
"Candy Crush Soda Saga"	(titel)
"Captain Toad: Treasure Tracker"	"Captain Toad: Treasure Tracker"
"Carcassonne"	Carcassonne
"Carmageddon II: Carpocalypse Now"	"Carmageddon II: Carpocalypse Now"
"Caste Ville"	(titel)
"Castle Clash"	(titel)
"Castle Crashers"	"Castle Crashers"
"Castle Crush"	(titel)
"Castle story"	(titel)
"CastleMiner Z"	(titel)
"Castlestorm"	Castlestorm
"Castlevania: Lords of Shadow"	"Castlevania: Lords of Shadow"
"Castlevania: Lords of Shadow - Mirror of Fate HD"	"Castlevania: Lords of Shadow - Mirror of Fate HD"
"Castlevania: Lords of Shadow 2"	"Castlevania: Lords of Shadow 2"
"Castlevania: Lords of Shadow – Mirror of Fate"	(titel)
"Catherine"	Catherine
"Cave Story+"	(titel)
"Ceasar IV"	(titel)
"Ceville"	Ceville
"Champions Online"	"Champions Online"
"Chaos auf Deponia"	"Chaos auf Deponia"
"Chariot"	(titel)
"Chess 2 - The Sequel"	(titel)
"Chess (Jeroen Carolus)"	(titel)
"Child of Light"	"Child of Light"
"Children of Mana"	"Children of Mana"
"Chivalry: Medieval Warfare"	"Chivalry: Medieval Warfare"
"Chrono Trigger"	"Chrono Trigger"
"Circuits"	(titel)
"Cities XL Platinum"	(titel)
"Cities in Motion"	"Cities in Motion"
"Cities in Motion 2"	"Cities in Motion 2"
"Civ. Beyond Earth"	(titel)
"Civilization  Beyond Earth"	(titel)
"Civilization Revolution"	(titel)
"Clash of Clans"	(titel)
"Clicker heroes"	(titel)
"Clonk Rage"	(titel)
"ClusterPuck 99"	(titel)
"Cognition: An Erica Reed Thriller"	(titel)
"Combat Arms"	"Combat Arms"
"Command & Conquer"	"Command & Conquer"
"Command & Conquer: Alarmstufe Rot 3"	"Command & Conquer: Alarmstufe Rot 3"
"Command & Conquer: Generals"	"Command & Conquer: Generals"
"Command & Conquer: Renegade"	"Command & Conquer: Renegade"
"Command & Conquer: Tiberian Sun"	"Command & Conquer: Tiberian Sun"
"Command & Conquer: Tiberium Alliances"	(titel)
"Command and Conquer 3: Tiberium Wars"	(titel)
"Company of  Heroes"	(titel)
"Company of  Heroes 2"	(titel)
"Company of Heroes"	"Company of Heroes"
"Company of Heroes 2"	"Company of Heroes 2"
"Construction Simulator 2015"	(titel)
"Contagion"	(titel)
"Cook, Serve, Delicious!"	(titel)
"Cookie Clicker"	(titel)
"CosmicBreak"	(titel)
"Cosmonautica"	(titel)
"Costume Quest"	"Costume Quest"
"Costume Quest 2"	"Costume Quest 2"
"Counter-Strike"	Counter-Strike
"Counter-Strike: Global Offensive"	"Counter-Strike: Global Offensive"
"Counter-Strike: Source"	"Counter-Strike: Source"
"Craft The World"	(titel)
"Crash Bandicoot 2"	(titel)
"Crawl"	(titel)
"Crazy Taxi"	"Crazy Taxi"
"Creeper World 3 - Knuckle Cracker"	(titel)
"Crime City"	"Crime City"
"Criminal Case"	(titel)
"Crimson Shroud"	"Crimson Shroud"
"Crimsonland"	Crimsonland
"Croqinole"	(titel)
"Crusader Kings II"	"Crusader Kings II"
"Cry of Fear"	(titel)
"Crypt of the NecroDancer"	(titel)
"Crysis"	Crysis
"Crysis 2"	"Crysis 2"
"Crysis 3"	"Crysis 3"
"Curve Fever"	(titel)
"Cut The Rope 2"	(titel)
"Cytus"	(titel)
"DARK"	Dark
"DC Universe Online"	"DC Universe Online"
"DCS: A-10C Warthog - Digital Combat Simulator"	(titel)
"DTM Experience 2014"	(titel)
"Daedelus"	(titel)
"Danganronpa"	(titel)
"Danganronpa 2: Goodbye Despair"	"Danganronpa 2: Goodbye Despair"
"Dark Age of Camelot"	"Dark Age of Camelot"
"Dark Chronicle"	"Dark Chronicle"
"Dark Messiah of Might and Magic"	(titel)
"Dark Project 2: The Metal Age"	(titel)
"Dark Project: Der Meisterdieb"	"Dark Project: Der Meisterdieb"
"Dark Raid"	(titel)
"Dark Souls"	"Dark Souls"
"Dark Souls - Prepare to Die Edition"	(titel)
"Dark Souls II"	"Dark Souls II"
"Darkest of Days"	"Darkest of Days"
"Darkfall Online"	(titel)
"Darkness Reborn"	(titel)
"Darkness Within: In Pursuit of Loath Nolder"	"Darkness Within: In Pursuit of Loath Nolder"
"Darksiders"	Darksiders
"Darksiders 2"	(titel)
"Darwinia"	Darwinia
"Das Schwarze Auge: Blackguards"	(titel)
"Das Schwarze Auge: Demonicon"	(titel)
"Das Schwarze Auge: Drakensang"	"Das Schwarze Auge: Drakensang"
"Das Schwarze Auge: Satinavs Ketten"	"Das Schwarze Auge: Satinavs Ketten"
"Dawn of War"	(titel)
"Dawn of War II"	(titel)
"Day of Defeat"	"Day of Defeat"
"Day of Defeat: Source"	"Day of Defeat: Source"
"DayZ Standalone"	(titel)
"Daylight"	Daylight
"Dead Island"	"Dead Island"
"Dead Island: Epidemic"	(titel)
"Dead Island: Riptide"	"Dead Island: Riptide"
"Dead Rising"	"Dead Rising"
"Dead Rising 3"	"Dead Rising 3"
"Dead Space"	"Dead Space"
"Dead Space 2"	"Dead Space 2"
"Dead Space 3"	"Dead Space 3"
"Dead State"	(titel)
"DeadCore"	(titel)
"Deadfall Adventures"	"Deadfall Adventures"
"Deadlight"	Deadlight
"Deadly Premonition"	"Deadly Premonition"
"Deadpool"	Deadpool
"Dear Esther"	(titel)
"Defender's Quest: Valley of the Forgotten"	(titel)
"Defense Grid 2"	"Defense Grid 2"
"Defense Grid: The Awakening"	"Defense Grid: The Awakening"
"Defiance"	Defiance
"Defy Gravity"	(titel)
"Deliverance-Kingdome Comes Tech Alpha"	(titel)
"Delta Force: Black Hawk Down"	"Delta Force: Black Hawk Down"
"Delver"	(titel)
"Democracy 3"	(titel)
"Demon's Souls"	"Demon's Souls"
"Deponia"	Deponia
"Deponia -  the Complete Journey"	(titel)
"Deponia: The Complete Journey"	(titel)
"Depth"	(titel)
"Der Herr der Ringe: Der Krieg im Norden"	"Der Herr der Ringe: Der Krieg im Norden"
"Der Herr der Ringe: Die Schlacht um Mittelerde"	"Der Herr der Ringe: Die Schlacht um Mittelerde"
"Der Herr der Ringe: Die Schlacht um Mittelerde 2"	(titel)
"Der Herr der Ringe Online"	(titel)
"Der Puppenspieler"	"Der Puppenspieler"
"Desperados: Wanted Dead or Alive"	"Desperados: Wanted Dead or Alive"
"Despicable Me: Minion Rush"	(titel)
"Destiny"	Destiny
"Deus Ex"	"Deus Ex"
"Deus Ex: Human Revolution"	"Deus Ex: Human Revolution"
"Deus Ex: The Fall"	"Deus Ex: The Fall"
"Devil May Cry"	"Devil May Cry"
"Devil's Attorney"	(titel)
"Diablo"	Diablo
"Diablo II"	"Diablo II"
"Diablo III"	"Diablo III"
"Die Gilde"	(titel)
"Die Kunst des Mordens: Geheimakte FBI"	"Die Kunst des Mordens: Geheimakte FBI"
"Die Siedler 7"	"Die Siedler 7"
"Die Siedler II"	"Die Siedler II"
"Die Siedler II – Die nächste Generation"	(titel)
"Die Siedler III"	"Die Siedler III"
"Die Siedler IV"	"Die Siedler IV"
"Die Siedler Online"	(titel)
"Die Siedler – Aufstieg eines Königreichs"	(titel)
"Die Sielder - Das Erbe der Könige"	(titel)
"Die Sims 2"	"Die Sims 2"
"Die Sims 3"	"Die Sims 3"
"Die Sims 4"	(titel)
"Die Stämme"	(titel)
"Dino D-Day"	(titel)
"Dirks kostenloser Fussballmanager"	(titel)
"Dirt 2"	"DiRT 2"
"Dirt 3"	"DiRT 3"
"Dirt: Showdown"	(titel)
"Dirty Bomb"	(titel)
"Dishonored: Die Maske des Zorns"	"Dishonored: Die Maske des Zorns"
"Disney Infinity"	(titel)
"Disney Infinity: 2.0 Edition"	(titel)
"Distant Worlds"	"Distant Worlds"
"Divine Divinity"	"Divine Divinity"
"Divinity 2: Ego Draconis"	(titel)
"Divinity: Original Sin"	"Divinity: Original Sin"
"Dofus"	(titel)
"Dogfight 1942"	"Dogfight 1942"
"Donkey Kong Country"	"Donkey Kong Country"
"Donkey Kong Country Returns"	"Donkey Kong Country Returns"
"Donkey Kong Country: Tropical Freeze"	"Donkey Kong Country: Tropical Freeze"
"Don't Starve"	"Don't Starve"
"Doodle God"	(titel)
"Doodle Jump"	"Doodle Jump"
"Doom"	Doom
"Doom & Destiny"	(titel)
"Doom 2"	(titel)
"Doom 3"	"Doom 3"
"Door Kickers"	(titel)
"Doppelkopf"	(titel)
"DotA 1"	(titel)
"Dota 2"	(titel)
"Downfall"	(titel)
"Dragon  Age: Inquisition"	(titel)
"Dragon Age  Inquisition"	(titel)
"Dragon Age II"	"Dragon Age II"
"Dragon Age: Inquisition"	"Dragon Age: Inquisition"
"Dragon Age. Inquisition"	(titel)
"Dragon Age: Origins"	"Dragon Age: Origins"
"Dragon Ball Z: Budokai Tenkaichi 2"	"Dragon Ball Z: Budokai Tenkaichi 2"
"Dragon Quest"	"Dragon Quest"
"Dragon Quest IX"	(titel)
"Dragon's Crown"	"Dragon's Crown"
"Dragon's Dogma"	"Dragon's Dogma"
"Drakengard 3"	"Drakengard 3"
"Drakensang Online"	(titel)
"Dreamfall Chapters: The Longest Journey"	(titel)
"Driftmoon"	(titel)
"Driveclub"	DriveClub
"Driver: San Francisco"	"Driver: San Francisco"
"Drunken Robot Pornography"	(titel)
"DuckTales: Remastered"	"DuckTales: Remastered"
"Ducktales"	DuckTales
"Duke Nukem 3D"	"Duke Nukem 3D"
"Duke Nukem Forever"	"Duke Nukem Forever"
"Duke Nukem: Land of the Babes"	"Duke Nukem: Land of the Babes"
"Duke Nukem: Manhattan Project"	"Duke Nukem: Manhattan Project"
"Duke Nukem: Time to Kill"	"Duke Nukem: Time to Kill"
"Dungeon Defenders"	"Dungeon Defenders"
"Dungeon Defenders II"	(titel)
"Dungeon Hunter 3"	(titel)
"Dungeon Hunter 4"	(titel)
"Dungeon Hunter: Alliance"	"Dungeon Hunter: Alliance"
"Dungeon Keeper"	"Dungeon Keeper"
"Dungeon Keeper 2"	"Dungeon Keeper 2"
"Dungeon Raid"	(titel)
"Dungeon Siege II"	"Dungeon Siege II"
"Dungeon Siege III"	"Dungeon Siege III"
"Dungeon Village"	(titel)
"Dungeon of Slyn"	(titel)
"Dungeon of the Endless"	(titel)
"Dungeons & Dragons: Neverwinter"	(titel)
"Dungeons of Dredmor"	(titel)
"Dust 514"	(titel)
"Dust: An Elysian Tail"	"Dust: An Elysian Tail"
"Dustforce"	(titel)
"Dwarf Fortress"	(titel)
"Dynasty Warriors 8"	"Dynasty Warriors 8"
"EA Sports UFC"	"EA Sports UFC"
"EDGE Extended"	(titel)
"EVE Online"	"EVE Online"
"E.Y.E: Divine Cybermancy"	(titel)
"Eador: Genesis"	"Eador: Genesis"
"Eador: Masters of the Broken World"	"Eador: Masters of the Broken World"
"Earn to Die"	(titel)
"Earth Defense Force 2025"	"Earth Defense Force 2025"
"East India Company"	"East India Company"
"Edge of Space"	(titel)
"Edna bricht aus"	"Edna bricht aus"
"Elder Sign: Omens"	(titel)
"Electronic Super Joy"	(titel)
"Elite"	Elite
"Elite: Dangerous"	"Elite: Dangerous"
"Elsword"	(titel)
"Emergency 2014"	"Emergency 2014"
"Emergency 4"	"Emergency 4"
"Emergency 5"	(titel)
"Emoji Quiz"	(titel)
"Empire Earth"	"Empire Earth"
"Empire: Total War"	"Empire: Total War"
"Endless Dungeon"	(titel)
"Endless Legend"	(titel)
"Endless Space"	(titel)
"Enemy Front"	"Enemy Front"
"English Country Tune"	(titel)
"Enslaved: Odyssey to the West"	"Enslaved: Odyssey to the West"
"Epic Cards Battle"	(titel)
"Escape Dead Island"	"Escape Dead Island"
"Escape Plan"	"Escape Plan"
"Eschalon"	(titel)
"Estraged"	(titel)
"Etrian Odyssey"	"Etrian Odyssey"
"Eufloria HD"	(titel)
"Euro Truck Simulator"	"Euro Truck Simulator"
"Euro Truck Simulator 2"	"Euro Truck Simulator 2"
"Euro Truck Simulator 2013"	(titel)
"Euro Trucksimulator 2014"	(titel)
"Europa Universalis"	"Europa Universalis"
"Europa Universalis III"	"Europa Universalis III"
"Europa Universalis IV"	"Europa Universalis IV"
"EverQuest II"	"EverQuest II"
"Evil Genius"	"Evil Genius"
"Evochron Mercenary"	(titel)
"Evoland: A Short Story of Adventure Video Games Evolution (GOG)"	"Evoland: A Short Story of Adventure Video Games Evolution (GOG)"
"Evolve"	(titel)
"Expeditions: Conquistador"	(titel)
"F1 2011"	"F1 2011"
"F1 2013"	"F1 2013"
"F1 2014"	"F1 2014"
"F1 Challenge 99-02"	(titel)
"F1 Race Stars"	"F1 Race Stars"
"F.E.A.R. 2"	(titel)
"F.E.A.R. 3"	"F.E.A.R. 3"
"FIFA  15"	(titel)
"FIFA 12"	"FIFA 12"
"FIFA 13"	"FIFA 13"
"FIFA 14"	"FIFA 14"
"FIFA 15"	"FIFA 15"
"FIFA World"	(titel)
"FORCED"	(titel)
"FTL: Faster Than Light"	(titel)
"F-Zero GX"	"F-Zero GX"
"Fable 2"	(titel)
"Fable Anniversary"	(titel)
"Fable III"	"Fable III"
"Factorio"	(titel)
"Faery - Legends of Avalon"	(titel)
"Falcon 4.0"	"Falcon 4.0"
"Fallout"	Fallout
"Fallout 2"	"Fallout 2"
"Fallout 3"	"Fallout 3"
"Fallout: New Vegas"	"Fallout: New Vegas"
"Family Guy: Mission Sachensuche"	(titel)
"Fantasia: Mickey Mouse Magic"	(titel)
"Fantasy Life"	"Fantasy Life"
"Far  Cry 3"	(titel)
"Far  cry 4"	(titel)
"Far Cry"	"Far Cry"
"Far Cry 2"	"Far Cry 2"
"Far Cry 3"	"Far Cry 3"
"Far Cry 3: Blood Dragon"	"Far Cry 3: Blood Dragon"
"Far Cry 4"	"Far Cry 4"
"FarmVille"	(titel)
"Farmville 2"	(titel)
"Farmville Heroes"	(titel)
"Fat Princess: Piece of Cake"	(titel)
"Fate/Stay Night"	(titel)
"Façade"	Façade
"Fez"	FEZ
"Final Fantasy"	"Final Fantasy"
"Final Fantasy II"	"Final Fantasy II"
"Final Fantasy III"	"Final Fantasy III"
"Final Fantasy V"	"Final Fantasy V"
"Final Fantasy VI"	"Final Fantasy VI"
"Final Fantasy VII"	"Final Fantasy VII"
"Final Fantasy VIII"	"Final Fantasy VIII"
"Final Fantasy X"	"Final Fantasy X"
"Final Fantasy X HD Remaster"	"Final Fantasy X HD Remaster"
"Final Fantasy XIII"	"Final Fantasy XIII"
"Final Fantasy XIII-2"	"Final Fantasy XIII-2"
"Final Fantasy XIV: A Realm Reborn"	(titel)
"Final Fight"	"Final Fight"
"Final Horizon"	"Final Horizon"
"Fire Emblem: Awakening"	"Fire Emblem: Awakening"
"Fire Emblem: Path of Radiance"	"Fire Emblem: Path of Radiance"
"Firefall"	(titel)
"Fist of Awesome"	"Fist of Awesome"
"Fistful of Frags"	(titel)
"Five Nights at Freddy's"	(titel)
"Flappy Crush"	(titel)
"FlatOut 2"	"FlatOut 2"
"Flight Control"	"Flight Control"
"Flight of the Amazon Queen"	"Flight of the Amazon Queen"
"Floating Point"	(titel)
"Flow Free: Bridges"	(titel)
"Football Manager 2014"	"Football Manager 2014"
"Football Manager 2015"	"Football Manager 2015"
"Forge Quest"	(titel)
"Forge of Empires"	(titel)
"Formel 1 2011"	(titel)
"Fortix 2"	(titel)
"Fortnite"	(titel)
"FortressCraft Evolved!"	(titel)
"Forza Horizon"	"Forza Horizon"
"Forza Horizon 2"	"Forza Horizon 2"
"Forza Motorsport  5"	(titel)
"Forza Motorsport 4"	"Forza Motorsport 4"
"Forza Motorsport 5"	"Forza Motorsport 5"
"Fractured Space"	(titel)
"Framed"	(titel)
"FreeCell"	Freecell
"Freecol"	(titel)
"Freedom Wars"	"Freedom Wars"
"Freelancer"	Freelancer
"Frets on Fire"	(titel)
"From the Depth"	(titel)
"Frozen: Olaf's Quest"	(titel)
"Frozen Synapse"	(titel)
"Fruit Ninja"	"Fruit Ninja"
"Fuchstreff: Doppelkopf für Füchse"	(titel)
"Full Mojo Rampage"	(titel)
"Fussball Manager 12"	"Fussball Manager 12"
"Fussball Manager 13"	"Fussball Manager 13"
"Fussball Manager 14"	(titel)
"Fußball Manager 13"	(titel)
"Fußball Manager 14"	(titel)
"Fußball manager 13"	(titel)
"GODUS"	(titel)
"GRID 2"	"GRID 2"
"Gabriel Knight: Sins of the Fathers"	"Gabriel Knight: Sins of the Fathers"
"Gabriel Knight: Sins of the Fathers 20th Anniversary Edition"	(titel)
"Galactic Civilizations II"	"Galactic Civilizations II"
"Galactic Civilizations III"	(titel)
"Galaxy on Fire"	(titel)
"Game Dev Tycoon"	(titel)
"Game Of Thrones Ascent"	(titel)
"Game of Thrones"	"Game of Thrones"
"Gang Beasts"	(titel)
"Gangsters: Organized Crime"	(titel)
"Gardenscape"	(titel)
"Garry's Mod"	(titel)
"Gas Guzzlers Extreme"	"Gas Guzzlers Extreme"
"Gauntlet"	Gauntlet
"Gear Up"	(titel)
"Gears of War"	"Gears of War"
"Gears of War 2"	"Gears of War 2"
"Gears of War 3"	"Gears of War 3"
"Geheimakte 2: Puritas Cordis"	"Geheimakte 2: Puritas Cordis"
"Geheimakte 3"	"Geheimakte 3"
"Geheimakte: Sam Peters"	(titel)
"Geheimakte Tunguska"	"Geheimakte Tunguska"
"Gender Bender DNA Twister Extreme"	(titel)
"Geometry Dash"	(titel)
"Geometry Wars 3: Dimensions"	"Geometry Wars 3: Dimensions"
"Ghost Recon: Future Soldier"	(titel)
"Giana Sisters: Twisted Dreams (Limited Edition)"	"Giana Sisters: Twisted Dreams (Limited Edition)"
"Goat Simulator"	(titel)
"God Mode"	"God Mode"
"God of War"	"God of War"
"God of War II"	"God of War II"
"Gods Will Be Watching"	(titel)
"Godville"	(titel)
"Goldeneye 007 (n64)"	(titel)
"Goodbye Deponia"	"Goodbye Deponia"
"Goodgame Empire"	(titel)
"Gothic"	Gothic
"Gothic 3"	"Gothic 3"
"Gothic II"	"Gothic II"
"Gothic II - Die  Nacht des Raben"	(titel)
"Gran Turismo 5"	"Gran Turismo 5"
"Gran Turismo 6"	"Gran Turismo 6"
"Grand Theft Auto"	"Grand Theft Auto"
"Grand Theft Auto III"	"Grand Theft Auto III"
"Grand Theft Auto IV"	"Grand Theft Auto IV"
"Grand Theft Auto: San Andreas"	"Grand Theft Auto: San Andreas"
"Grand Theft Auto V"	"Grand Theft Auto V"
"Grand Theft Auto: Vice City"	"Grand Theft Auto: Vice City"
"Gray Matter"	"Gray Matter"
"Great Big war game"	(titel)
"Grid Autosport"	(titel)
"Grim Dawn"	(titel)
"Grotesque Tactics 2: Dungeons and Donuts"	(titel)
"Guacamelee!"	Guacamelee!
"Guild Wars"	"Guild Wars"
"Guild Wars 2"	"Guild Wars 2"
"Guilty Gear Xrd"	(titel)
"Guitar Hero"	"Guitar Hero"
"Gunman Chronicles"	"Gunman Chronicles"
"Gunpoint"	(titel)
"Guns of Icarus Online"	(titel)
"Haegemonia: Legions of Iron"	"Haegemonia: Legions of Iron"
"Half-Life"	Half-Life
"Half-Life 2"	"Half-Life 2"
"Half-Life: Source"	"Half-Life: Source"
"Halfway"	(titel)
"Halo - The Master Chief Collection"	(titel)
"Halo 2"	"Halo 2"
"Halo 3"	"Halo 3"
"Halo 4"	"Halo 4"
"Halo 5: Guardians"	(titel)
"Halo: Combat Evolved"	"Halo: Combat Evolved"
"Halo: Combat Evolved Anniversary"	"Halo: Combat Evolved Anniversary"
"Halo: Reach"	"Halo: Reach"
"Halo: Spartan Assault"	"Halo: Spartan Assault"
"Hammerwatch"	(titel)
"Happy Wars"	"Happy Wars"
"Happy Wheels"	(titel)
"Hard Reset (Extended Edition)"	"Hard Reset (Extended Edition)"
"Hardboiled Chicken"	(titel)
"Harvest Moon DS"	"Harvest Moon DS"
"Harveys Neue Augen"	"Harveys neue Augen"
"Hashi"	(titel)
"Hatsune Miku: Project Diva F 2nd"	"Hatsune Miku: Project DIVA F 2nd"
"Hawken"	(titel)
"Haxball"	(titel)
"Hay Day"	(titel)
"Hazard Ops"	(titel)
"Hearthstone: Heroes of Warcraft"	(titel)
"Hearts of Iron II"	"Hearts of Iron II"
"Hearts of Iron III"	"Hearts of Iron III"
"Heavy Rain"	"Heavy Rain"
"Helden von Camelot"	(titel)
"Hellgate: London"	"Hellgate: London"
"Hero Siege"	(titel)
"Heroes & Generals"	(titel)
"Heroes Charge"	(titel)
"Heroes of Dragon Age"	(titel)
"Heroes of Might and  Magic 5"	(titel)
"Heroes of Might and Magic 2"	(titel)
"Heroes of Might and Magic 6"	(titel)
"Heroes of Might and Magic III: The Restoration of Erathia"	"Heroes of Might and Magic III: The Restoration of Erathia"
"Heroes of Might and Magic V"	"Heroes of Might and Magic V"
"Heroes of Newerth"	"Heroes of Newerth"
"Heroes of storm"	(titel)
"Heroes of the Storm"	(titel)
"Heroine's Quest: The Herald of Ragnarok"	(titel)
"Herrscher des Olymp – Zeus"	(titel)
"Hex: Shards of Fate"	(titel)
"Hexcells Infinite"	(titel)
"Hexcells Plus"	(titel)
"Hidden & Dangerous 2"	"Hidden & Dangerous 2"
"Highway Racer 3D"	(titel)
"Hill Climb Racing"	(titel)
"Hitman"	(titel)
"Hitman: Absolution"	"Hitman: Absolution"
"Hitman: Blood Money"	"Hitman: Blood Money"
"Hitman: Contracts"	"Hitman: Contracts"
"Hitman GO"	(titel)
"Homefront"	Homefront
"Homeworld"	Homeworld
"Hoplite"	Hoplite
"Horizon"	(titel)
"Horizon 2"	(titel)
"Hotline Miami"	"Hotline Miami"
"How to Survive"	"How to Survive"
"Hyperdimension Neptunia"	"Hyperdimension Neptunia"
"Hyperdimension Neptunia Re;Birth1"	(titel)
"Hyrule Warriors"	"Hyrule Warriors"
"I Am Alive"	"I Am Alive"
"I am Bread"	(titel)
"IL-2 Sturmovik: Battle of Stalingrad"	"IL-2 Sturmovik: Battle of Stalingrad"
"IL-2 Sturmovik: Cliffs of Dover"	"IL-2 Sturmovik: Cliffs of Dover"
"Ice Age: Die Siedlung"	(titel)
"Ice Breaker"	(titel)
"Icewind Dale"	"Icewind Dale"
"Icewind Dale: Enhanced Edition"	(titel)
"Idle Oil Tycoon"	(titel)
"Imouto Ijime"	(titel)
"InFamous: First Light"	"inFamous: First Light"
"InWorldz"	(titel)
"Indiana  Jones-greatest Adventures"	(titel)
"Indiana Jones and the Fate of Atlantis"	"Indiana Jones and the Fate of Atlantis"
"Infestation"	Infestation
"Infinite Undiscovery"	"Infinite Undiscovery"
"Infinity Blade II"	"Infinity Blade II"
"Infinity Wars"	(titel)
"InflationRPG"	(titel)
"Ingress"	(titel)
"Injustice: Gods Among Us"	"Injustice: Gods Among Us"
"Insane 2"	"Insane 2"
"Insurgency: Modern Infantry Combat"	(titel)
"Invisible Inc."	(titel)
"Jade Empire"	"Jade Empire"
"Jagged Alliance 2"	"Jagged Alliance 2"
"Jagged Alliance: Back in Action"	"Jagged Alliance: Back in Action"
"Jazz Jackrabbit 2"	(titel)
"Jazzpunk"	(titel)
"Jetpack Joyride"	"Jetpack Joyride"
"Journey"	Journey
"Just Cause"	"Just Cause"
"Just Cause 2"	"Just Cause 2"
"Just Dance 2014"	"Just Dance 2014"
"Just Dance 2015"	"Just Dance 2015"
"Kairo"	(titel)
"Kalah!"	(titel)
"Kane & Lynch: Dead Men"	"Kane & Lynch: Dead Men"
"Kantai Collection"	(titel)
"Kenshi"	(titel)
"Kentucky Road Zero"	(titel)
"Kentucky Route Zero"	(titel)
"Kerbal Space Program"	"Kerbal Space Program"
"Kid Icarus: Uprising"	"Kid Icarus: Uprising"
"Killer Instinct"	"Killer Instinct"
"Killer is Dead"	"Killer is Dead"
"Killing Floor"	(titel)
"Killzone 3"	"Killzone 3"
"Killzone: Shadow Fall"	"Killzone: Shadow Fall"
"King of Dragon Pass"	"King of Dragon Pass"
"Kingdom Come: Deliverance"	(titel)
"Kingdom Hearts"	"Kingdom Hearts"
"Kingdom Hearts 1.5 HD Remix"	(titel)
"Kingdom Hearts II"	"Kingdom Hearts II"
"Kingdom Hearts II HD"	(titel)
"Kingdom Rush"	"Kingdom Rush"
"Kingdom Rush HD"	(titel)
"Kingdom hearts 2.5 HD Remix"	(titel)
"Kingdom of Loathing"	(titel)
"Kingdoms of Amalur: Reckoning"	"Kingdoms of Amalur: Reckoning"
"King's Bounty: Warriors of the North"	"King's Bounty: Warriors of the North"
"Knack"	Knack
"KnightShift"	Knightshift
"Knights of Honor"	"Knights of Honor"
"L.A. Noire"	"L.A. Noire"
"LEGO Batman 2"	(titel)
"LEGO Batman 3: Beyond Gotham"	(titel)
"LEGO Batman: The Videogame"	"LEGO Batman: The Videogame"
"LEGO City Undercover"	(titel)
"LEGO Der Herr der Ringe"	"LEGO Der Herr der Ringe"
"LEGO: Der Hobbit"	(titel)
"LEGO Indiana Jones"	"LEGO Indiana Jones"
"LEGO Marvel Super Heroes"	"LEGO Marvel Super Heroes"
"LEGO Movie"	(titel)
"LEGO Pirates of the Caribbean"	(titel)
"LEGO Star Wars"	(titel)
"LIMBO"	Limbo
"LYNE"	LYNE
"Landmark"	(titel)
"Landwirtschafts-Simulator 2013"	(titel)
"Landwirtschafts-Simulator 2014"	(titel)
"Landwirtschafts-Simulator 2015"	(titel)
"Lara Croft and the Guardian of Light"	"Lara Croft and the Guardian of Light"
"Lara Croft und der Tempel des Osiris"	(titel)
"Last  of Us"	(titel)
"Last Chaos"	"Last Chaos"
"League of Legends"	(titel)
"Left 4 Dead"	"Left 4 Dead"
"Left 4 Dead 2"	"Left 4 Dead 2"
"Legacy of Kain"	(titel)
"Legacy of Kain: Soul Reaver"	"Legacy of Kain: Soul Reaver"
"Legend of Grimrock"	(titel)
"Legend of Grimrock 2"	(titel)
"Lego Star Wars: The Complete Saga"	"LEGO Star Wars: The Complete Saga"
"Letter Quest: Grimm's Journey"	(titel)
"Lichdom: Battlemage"	(titel)
"Life is Feudal"	(titel)
"Life is Feudal: Your Own"	(titel)
"Lightning Returns: Final Fantasy XIII"	"Lightning Returns: Final Fantasy XIII"
"Little Big Planet 2"	(titel)
"LittleBigPlanet"	LittleBigPlanet
"LittleBigPlanet 3"	"LittleBigPlanet 3"
"LittleBigPlanet: Karting"	(titel)
"Live for Speed"	(titel)
"Loadout"	(titel)
"Lords of Xulima"	(titel)
"Lords of the Fallen"	"Lords of the Fallen"
"Lost Horizon"	"Lost Horizon"
"Lost Planet 3"	"Lost Planet 3"
"Lucius"	Lucius
"Lufia"	Lufia
"Luigi's Mansion"	"Luigi's Mansion"
"Luigi's Mansion 2"	"Luigi's Mansion 2"
"Lux Touch"	(titel)
"Lylat Wars"	"Lylat Wars"
"MLB 14 The Show"	(titel)
"MXGP - The Official Motocross Videogame"	(titel)
"Machinarium"	Machinarium
"Mad Games Tycoon"	(titel)
"Madden NFL 09"	"Madden NFL 09"
"Madden NFL 15"	(titel)
"Madden NFL 25"	"Madden NFL 25"
"Madden nfl 13"	"Madden NFL 13"
"Mafia II"	"Mafia II"
"Magic 2014: Duels of the Planeswalkers"	(titel)
"Magic 2015 - Duels of the Planeswalkers"	(titel)
"Magic: The Gathering"	(titel)
"Magicite"	(titel)
"Magicka"	Magicka
"MagnaCarta 2"	(titel)
"Mahjong Tower"	(titel)
"Maia"	(titel)
"Manhunt"	Manhunt
"Manhunt 2"	"Manhunt 2"
"Maniac Mansion"	"Maniac Mansion"
"Mario Kart 64"	"Mario Kart 64"
"Mario Kart 7"	"Mario Kart 7"
"Mario Kart 8"	"Mario Kart 8"
"Mario Kart Wii"	"Mario Kart Wii"
"Mario Party 7"	(titel)
"Mark of the Ninja"	"Mark of the Ninja"
"Mars Effect"	(titel)
"Marvel Heroes 2015"	(titel)
"Marvel Puzzle Quest: Dark Reign"	(titel)
"Marvel: Ultimate Alliance"	"Marvel: Ultimate Alliance"
"Marvel vs StreetFighter"	(titel)
"Mashed"	(titel)
"Mass Effect"	"Mass Effect"
"Mass Effect 2"	"Mass Effect 2"
"Mass Effect 3"	"Mass Effect 3"
"Master of Orion II: Battle at Antares"	"Master of Orion II: Battle at Antares"
"Mata Hari"	"Mata Hari"
"Max & Mario - Die Rache des Dr. Düster"	(titel)
"Max Payne"	"Max Payne"
"Max Payne 2: The Fall of Max Payne"	"Max Payne 2: The Fall of Max Payne"
"Max Payne 3"	"Max Payne 3"
"McPixel"	(titel)
"MechWarrior 4: Mercenaries"	"Mechwarrior 4: Mercenaries"
"MechWarrior Online"	(titel)
"Medal of Honor: Allied Assault"	"Medal of Honor: Allied Assault"
"Medal of Honor: Warfighter"	"Medal of Honor: Warfighter"
"Medieval II: Total War"	"Medieval II: Total War"
"Medieval: Total War"	"Medieval: Total War"
"Mega Man 3"	"Mega Man 3"
"Melody's Escape"	(titel)
"Memoria"	(titel)
"Men of War: Assault Squad"	"Men of War: Assault Squad"
"Men of War: Assault Squad 2"	"Men of War: Assault Squad 2"
"Mercenary Kings"	"Mercenary Kings"
"Merchants of Kaidan"	(titel)
"Metal Gear Rising: Revengeance"	"Metal Gear Rising: Revengeance"
"Metal Gear Solid"	"Metal Gear Solid"
"Metal Gear Solid 2: Sons of Liberty"	"Metal Gear Solid 2: Sons of Liberty"
"Metal Gear Solid 3: Snake Eater"	"Metal Gear Solid 3: Snake Eater"
"Metal Gear Solid 4: Guns of the Patriots"	"Metal Gear Solid 4: Guns of the Patriots"
"Metal Gear Solid 5: Ground Zeroes"	(titel)
"Metal Gear Solid: Peace Walker"	"Metal Gear Solid: Peace Walker"
"Metal Slug 3"	"Metal Slug 3"
"Metro 2033"	"Metro 2033"
"Metro 2033 Redux"	"Metro 2033 Redux"
"Metro: Last Light"	"Metro: Last Light"
"Metro: Last Light Redux"	"Metro: Last Light Redux"
"Metroid: Other M"	"Metroid: Other M"
"Microsoft Flight Simulator X"	"Microsoft Flight Simulator X"
"Might & Magic: Clash of Heroes"	"Might & Magic: Clash of Heroes"
"Might & Magic Duel of Champions"	(titel)
"Might & Magic: Heroes 6"	(titel)
"Might & Magic VI: The Mandate of Heaven"	(titel)
"Might & Magic X: Legacy"	(titel)
"Might and Magic Heroes VI"	(titel)
"Might and Magic VIII: Day of the Destroyer"	"Might and Magic VIII: Day of the Destroyer"
"Minecraft"	Minecraft
"Mines of Mars"	(titel)
"Minesweeper"	(titel)
"Minetest"	(titel)
"Mini Metro"	(titel)
"Mini Ninjas"	"Mini Ninjas"
"MiniDayZ"	(titel)
"Minimum"	(titel)
"Mirror's Edge"	"Mirror's Edge"
"Mittelerde: Mordors Schatten"	"Mittelerde: Mordors Schatten"
"Monaco: What's Yours is Mine"	"Monaco: What's Yours is Mine"
"Monkey Island 2: LeChuck's Revenge"	"Monkey Island 2: LeChuck's Revenge"
"Monopoly App"	(titel)
"Monopoly Plus"	(titel)
"Monster Hunter 3 Ultimate"	"Monster Hunter 3 Ultimate"
"Monster Hunter Freedom Unite"	(titel)
"Monstermind"	(titel)
"Monument Valley"	"Monument Valley"
"Mordheim: City of the Damned"	(titel)
"Mortal Kombat (2011)"	(titel)
"MotoGP 14"	"MotoGP 14"
"Mount&Blade: Warband"	(titel)
"Mountain"	(titel)
"Muramasa Rebirth"	"Muramasa Rebirth"
"Murdered: Soul Suspect"	"Murdered: Soul Suspect"
"My Lands"	(titel)
"My Little Pony: Friendship Is Magic"	(titel)
"Mystery Case Files: Dire Grove, Sacred Grove"	(titel)
"NASCAR '14"	(titel)
"NBA 2K12"	"NBA 2K12"
"NBA 2K13"	"NBA 2K13"
"NBA 2K14"	"NBA 2K14"
"NBA 2k15"	(titel)
"NEO Scavenger"	(titel)
"NHL 14"	"NHL 14"
"NHL 15"	"NHL 15"
"Nano Assault Neo"	"Nano Assault Neo"
"Napoleon: Total War"	"Napoleon: Total War"
"Naruto Shippuden: Ultimate Ninja Storm 3"	"Naruto Shippuden: Ultimate Ninja Storm 3"
"Naruto Shippuden: Ultimate Ninja Storm Revolution"	"Naruto Shippuden: Ultimate Ninja Storm Revolution"
"Naruto Shippuuden: Narutimate Storm Revolution"	(titel)
"Nation Red"	(titel)
"Natural Doctrine"	"Natural Doctrine"
"Natural Selection 2"	(titel)
"Need For Speed"	(titel)
"Need For Speed: Carbon"	"Need for Speed: Carbon"
"Need for Speed: Brennender Asphalt"	"Need for Speed: Brennender Asphalt"
"Need for Speed: Hot Pursuit"	"Need for Speed: Hot Pursuit"
"Need for Speed: Most Wanted"	"Need for Speed: Most Wanted"
"Need for Speed: Most Wanted (Origin)"	"Need for Speed: Most Wanted (Origin)"
"Need for Speed: Rivals"	"Need for Speed: Rivals"
"Need for Speed: Shift"	"Need for Speed: Shift"
"Need for Speed: The Crew"	(titel)
"Need for Speed: The Run"	"Need for Speed: The Run"
"Need for Speed Underground  2"	(titel)
"Need for Speed: Underground 2"	"Need for Speed: Underground 2"
"Need for Speed World"	(titel)
"Neuroshima  Hex"	(titel)
"Never Alone"	(titel)
"Neverwinter Nights"	"Neverwinter Nights"
"Neverwinter Nights 2"	"Neverwinter Nights 2"
"New Super Luigi U"	"New Super Luigi U"
"New Super Mario Bros. 2"	"New Super Mario Bros. 2"
"New Super Mario Bros. U"	"New Super Mario Bros. U"
"New Super Mario Bros. Wii"	"New Super Mario Bros. Wii"
"Next Car Game: Wreckfest"	(titel)
"Ni No Kuni"	(titel)
"Nickelodeon's The Legend of Korra"	(titel)
"Nidhogg"	(titel)
"Nimble Quest"	(titel)
"Ninja Gaiden 3 Razor's Edge"	(titel)
"Nitro Nation Online"	(titel)
"No More Room In Hell"	(titel)
"Nobunaga's Ambition: Souzou"	(titel)
"Nosgoth"	(titel)
"NotTetris"	(titel)
"Nuclear Throne"	(titel)
"OMSI 2"	(titel)
"ORION: Prelude"	(titel)
"Obscure II"	"ObsCure II"
"Obulis"	(titel)
"Octodad"	(titel)
"Octodad: Dadliest Catch"	(titel)
"Oddworld: Abe's Oddysee"	"Oddworld: Abe's Oddysee"
"Ogame"	(titel)
"Okami"	(titel)
"One Finger Death Punch"	"One Finger Death Punch"
"One Piece: Pirate Warriors"	"One Piece: Pirate Warriors"
"One Piece: Pirate Warriors 2"	"One Piece: Pirate Warriors 2"
"OpenTTD"	OpenTTD
"Operation Flashpoint: Red River"	"Operation Flashpoint: Red River"
"Orcs Must Die! 2"	(titel)
"Osu!"	(titel)
"Otomaid @ Cafe"	(titel)
"Outlast (GOG)"	"Outlast (GOG)"
"Outlaws"	Outlaws
"Overruled!"	(titel)
"P.T."	P.T.
"Painkiller"	Painkiller
"Pandora - First Contact"	(titel)
"Panzer Corps: Wehrmacht"	(titel)
"Papers, Please"	(titel)
"Path of  Exile"	(titel)
"Path of Exile"	"Path of Exile"
"Pathfinder Online"	(titel)
"Patrizier IV"	"Patrizier IV"
"PayDay"	(titel)
"PayDay 2"	"Payday 2"
"Payday: The Heist"	"Payday: The Heist"
"Peggle"	Peggle
"Peggle 2"	"Peggle 2"
"Penumbra: Overture"	"Penumbra: Overture"
"Persona 4: The Ultimax Ultra Suplex Hold"	"Persona 4: The Ultimax Ultra Suplex Hold"
"Persona Q: Shadow of the Labyrinth"	"Persona Q: Shadow of the Labyrinth"
"Pflanzen gegen Zombies"	"Pflanzen gegen Zombies"
"Pflanzen gegen Zombies 2"	(titel)
"Pflanzen gegen Zombies: Garden Warfare"	(titel)
"Phantasy Star Online 2"	(titel)
"Pharaoh"	Pharaoh
"Piano Tiles (Don't Tap The White Tile)"	(titel)
"Picmi"	(titel)
"Picross E4"	(titel)
"Pikmin"	Pikmin
"Pikmin 3"	"Pikmin 3"
"Pinball FX2"	"Pinball FX2"
"Pixel Dungeon"	(titel)
"PixelJunk Monsters Ultimate"	(titel)
"Pizza Connection"	"Pizza Connection"
"Plague Inc."	"Plague Inc."
"Plague Inc. Evolved"	(titel)
"Planetary Annihilation"	(titel)
"Planetside  2"	(titel)
"Planetside 2"	"PlanetSide 2"
"Plants vs.  Zombie"	(titel)
"Play Epic Battle Fantasy 4"	(titel)
"Playstation Home"	(titel)
"Pokémon Feuerrot/Blattgrün"	(titel)
"Pokémon Gelb"	(titel)
"Pokémon Mystery Dungeon 2"	(titel)
"Pokémon Mystery Dungeon: Explorers of Sky"	(titel)
"Pokémon Omega  Rubin"	(titel)
"Pokémon Omega Rubin/Alpha Saphir"	(titel)
"Pokémon Platin-Edition"	"Pokémon Platin-Edition"
"Pokémon: Schwarz/Weiß"	(titel)
"Pokémon: Schwarz/Weiß 2"	(titel)
"Pokémon Showdown"	(titel)
"Pokémon Silber/Gold"	(titel)
"Pokémon Smaragd"	(titel)
"Pokémon: SoulSilver/HeartGold"	(titel)
"Pokémon Trading Card Game Online"	(titel)
"Pokémon X/Y"	(titel)
"Pool Nation"	"Pool Nation"
"Port Royale 3"	"Port Royale 3"
"Portal"	Portal
"Portal 2"	"Portal 2"
"Postal 2"	"Postal 2"
"Powerstar Golf"	(titel)
"Primal Carnage: Extinction"	(titel)
"Primordia"	(titel)
"Prince of Persia: The Sands of Time"	"Prince of Persia: The Sands of Time"
"Prison Architect"	(titel)
"Prison Rape Simulator 2014"	(titel)
"Pro Cycling Manager 2013"	(titel)
"Pro Evolution Soccer 2013"	"Pro Evolution Soccer 2013"
"Pro Evolution Soccer 2014"	"Pro Evolution Soccer 2014"
"Pro Evolution Soccer 2015"	"Pro Evolution Soccer 2015"
"Pro Evolution Soccer 6"	"Pro Evolution Soccer 6"
"Professor Layton und das Geheimnisvolle  Dorf"	(titel)
"Professor Layton und das Vermächtnis von Aslant"	"Professor Layton und das Vermächtnis von Aslant"
"Professor Layton und die Maske der Wunder"	"Professor Layton und die Maske der Wunder"
"Professor Layton vs. Phoenix Wright: Ace Attorney"	"Professor Layton vs. Phoenix Wright: Ace Attorney"
"Project CARS"	(titel)
"Project Zomboid"	(titel)
"Prototype"	Prototype
"Prototype 2"	"Prototype 2"
"Psychonauts"	Psychonauts
"Pure Pool"	"Pure Pool"
"Quake"	Quake
"Quake 4"	"Quake 4"
"Quake III Arena"	"Quake III Arena"
"Quake Live"	"Quake Live"
"Quantum Conundrum"	"Quantum Conundrum"
"Quizduell"	(titel)
"RESOGUN"	Resogun
"RETRY"	Retry
"R.U.S.E."	R.U.S.E.
"Race 07: Official WTCC Game"	"Race 07: Official WTCC Game"
"Race Driver: GRID"	(titel)
"Race The Sun"	"Race The Sun"
"RaceRoom Racing Experience"	(titel)
"Radiant Historia"	"Radiant Historia"
"Rage"	Rage
"Rage of Bahamut"	(titel)
"Ragnarok Online 2"	(titel)
"Ragnarok Online (20 Tage kostenlos)"	"Ragnarok Online (20 Tage kostenlos)"
"Raiden III"	"Raiden III"
"Rail Nation"	(titel)
"Rambo: The Video Game"	"Rambo: The Video Game"
"Randal's Monday"	(titel)
"Ratchet & Clank Future: A Crack in Time"	"Ratchet & Clank Future: A Crack in Time"
"Ravaged Zombie Apocalypse"	(titel)
"Rayman"	Rayman
"Rayman Legends"	"Rayman Legends"
"Rayman Origins"	"Rayman Origins"
"Rayman Raving Rabbids"	"Rayman Raving Rabbids"
"ReRave"	(titel)
"Real Racing 3"	"Real Racing 3"
"Real World Racing"	(titel)
"Realms of the Haunting"	"Realms of the Haunting"
"Rebuild 2"	(titel)
"Recruits - Make Heroes. Make History"	(titel)
"Red Dead Redemption"	"Red Dead Redemption"
"Red Faction"	"Red Faction"
"Red Faction: Armageddon"	"Red Faction: Armageddon"
"Red Faction: Guerrilla"	"Red Faction: Guerrilla"
"Red Orchestra: Ostfront 41-45"	"Red Orchestra: Ostfront 41-45"
"Reflec Beat plus!"	(titel)
"Reflex"	(titel)
"Remeber Me"	(titel)
"Renegade Ops"	"Renegade Ops"
"Renegade-x"	(titel)
"Resident Evil 4"	"Resident Evil 4"
"Resident Evil 5"	"Resident Evil 5"
"Resident Evil 6"	"Resident Evil 6"
"Resident Evil: Darkside Chronicles"	(titel)
"Resident Evil: Revelations"	"Resident Evil: Revelations"
"Resonance"	Resonance
"Return to Castle Wolfenstein"	"Return to Castle Wolfenstein"
"Rift"	Rift
"Rise of Flight"	(titel)
"Rise of Nations"	"Rise of Nations"
"Rise of Venice"	"Rise of Venice"
"Rise of the Triad"	"Rise of the Triad"
"Risen"	Risen
"Risen 2: Dark Waters"	"Risen 2: Dark Waters"
"Risen 3: Titan Lords"	"Risen 3: Titan Lords"
"Rising Storm"	"Rising Storm"
"Risk of Rain"	(titel)
"Roads of Rome 3"	"Roads of Rome 3"
"Robocraft"	(titel)
"RockBand"	(titel)
"Rockband 3"	(titel)
"Rocksmith 2014"	"Rocksmith 2014"
"Rogue Legacy"	"Rogue Legacy"
"RollerCoaster Tycoon"	"RollerCoaster Tycoon"
"RollerCoaster Tycoon 2"	"RollerCoaster Tycoon 2"
"RollerCoaster Tycoon 3"	"RollerCoaster Tycoon 3"
"Rome: Total War"	"Rome: Total War"
"Rules!"	Rules!
"Rumble Roses XX"	"Rumble Roses XX"
"Runaway: A Road Adventure"	"Runaway: A Road Adventure"
"Rune Factory 4"	"Rune Factory 4"
"Rune Factory Frontier"	(titel)
"Runes of Magic"	"Runes of Magic"
"Runescape"	(titel)
"Running with Rifles"	(titel)
"Rust"	(titel)
"Ryse: Son of Rome"	"Ryse: Son of Rome"
"S4 League"	(titel)
"S.K.I.L.L.-Special Force 2"	(titel)
"S.N.O.W."	(titel)
"S.O.L : Stone of Life EX"	(titel)
"S.T.A.L.K.E.R.: Call of Pripyat"	"S.T.A.L.K.E.R.: Call of Pripyat"
"S.T.A.L.K.E.R.: Clear Sky"	"S.T.A.L.K.E.R.: Clear Sky"
"S.T.A.L.K.E.R.: Shadow of Chernobyl"	"S.T.A.L.K.E.R.: Shadow of Chernobyl"
"SWAT 3"	(titel)
"SWAT 4"	"SWAT 4"
"Sacred"	Sacred
"Sacred 3"	"Sacred 3"
"Sacred Citadel"	"Sacred Citadel"
"Saints Row 2"	"Saints Row 2"
"Saints Row IV"	"Saints Row IV"
"Saints Row: The Third"	"Saints Row: The Third"
"Sakura Spirit"	(titel)
"Samurai Warriors 4"	"Samurai Warriors 4"
"Sanctum"	Sanctum
"Sanctum 2"	(titel)
"Satellite Reign"	(titel)
"Sauspiel Schafkopf"	(titel)
"Scarlet Blade"	(titel)
"Schleichfahrt"	Schleichfahrt
"School of Dragons"	(titel)
"Scrabble (Smartphone)"	(titel)
"Screencheat"	(titel)
"Scrolls"	(titel)
"Secret Ponchos"	"Secret Ponchos"
"Secret Weapons over Normandy"	"Secret Weapons over Normandy"
"Secret of Evermore"	"Secret of Evermore"
"Secret of Mana"	"Secret of Mana"
"Senran Kagura Shinovi Versus"	(titel)
"Sentinel 3: Homeworld"	"Sentinel 3: Homeworld"
"Serious Sam 2 HD"	(titel)
"Serious Sam 3: BFE"	"Serious Sam 3: BFE"
"Serious Sam HD: The First Encounter"	"Serious Sam HD: The First Encounter"
"Severance: Blade of Darkness"	"Severance: Blade of Darkness"
"Shadow  Warrior"	(titel)
"Shadow Hearts"	"Shadow Hearts"
"Shadow Kings"	(titel)
"Shadow Man"	"Shadow Man"
"Shadow Warrior"	"Shadow Warrior"
"Shadow Warrior (2013)"	(titel)
"Shadowrun: Dragonfall"	(titel)
"Shadowrun Returns"	"Shadowrun Returns"
"Shakes & Fidget"	(titel)
"Shakes and Fidget"	(titel)
"Shantae"	Shantae
"Shattered Horizon"	(titel)
"Shaun White Snowboarding"	"Shaun White Snowboarding"
"Sherlock Holmes: Crimes and Punishments"	(titel)
"Sherlock Holmes and the Hound of Baskervilles"	(titel)
"Shift 2: Unleashed"	"Shift 2: Unleashed"
"Shin Megami Tensei: Digital Devil Saga"	"Shin Megami Tensei: Digital Devil Saga"
"Shin Megami Tensei: Persona 3"	"Shin Megami Tensei: Persona 3"
"Shin Megami Tensei: Persona 4"	"Shin Megami Tensei: Persona 4"
"ShootMania"	(titel)
"Shovel Knight"	"Shovel Knight"
"Shroud of the Avatar: Forsaken Virtues"	(titel)
"Sid Meier's Alpha Centauri"	"Sid Meier's Alpha Centauri"
"Sid Meier's Civilization: Beyond Earth"	"Sid Meier's Civilization: Beyond Earth"
"Sid Meier's Civilization II"	"Sid Meier's Civilization II"
"Sid Meier's Civilization III"	"Sid Meier's Civilization III"
"Sid Meier's Civilization IV"	"Sid Meier's Civilization IV"
"Sid Meier's Civilization IV: Colonization"	"Sid Meier's Civilization IV: Colonization"
"Sid Meier's Civilization V"	(titel)
"Sid Meier's Pirates!"	"Sid Meier's Pirates!"
"Sid Meier's Railroad Tycoon"	"Sid Meier's Railroad Tycoon"
"Sideswiped"	(titel)
"Sightline: The Chair"	(titel)
"Silent Hill (1999)"	(titel)
"Silent Hill 2"	"Silent Hill 2"
"Silent Hunter 3"	(titel)
"Silent Hunter 4"	(titel)
"Silent Hunter 5: Battle of the Atlantic"	"Silent Hunter 5: Battle of the Atlantic"
"Sim City (2013)"	(titel)
"SimCity 4"	(titel)
"Simcity 2000 (1994)"	(titel)
"Simon the Sorcerer"	"Simon the Sorcerer"
"Sing Party"	(titel)
"Singstar"	SingStar
"Singularity"	Singularity
"Sins of a Solar Empire"	"Sins of a Solar Empire"
"Sins of the Dark Age"	(titel)
"Sir, you are being hunted"	(titel)
"Skull Girls"	(titel)
"Skullgirls"	Skullgirls
"Skylanders Giants"	(titel)
"Skylanders: Swap Force (Starter Pack)"	"Skylanders: Swap Force (Starter Pack)"
"Skylanders: Trap Team"	(titel)
"Sleeping Dogs"	"Sleeping Dogs"
"Slenderman"	(titel)
"Sly Cooper: Thieves in Time"	"Sly Cooper: Thieves in Time"
"Small World"	(titel)
"Smash Tennis"	"Smash Tennis"
"Smite"	(titel)
"Smugglers 5"	(titel)
"Sniper Elite 3"	(titel)
"Sniper Elite: Nazi Zombie Army 2"	"Sniper Elite: Nazi Zombie Army 2"
"Sniper Elite V2"	"Sniper Elite V2"
"Sniper Elite: Zombie Army"	"Sniper Elite: Zombie Army"
"SolForge"	(titel)
"Solitär"	Solitär
"Sonic & All-Stars Racing Transformed"	"Sonic & All-Stars Racing Transformed"
"Sonic Adventure DX"	"Sonic Adventure DX"
"Sonic Boom: Rise of Lyric"	(titel)
"Sonic Generations"	"Sonic Generations"
"Sonic the Hedgehog 2"	"Sonic the Hedgehog 2"
"South Park: Der Stab der Wahrheit"	"South Park: Der Stab der Wahrheit"
"Space Age: A Game of Space Adventure"	(titel)
"Space Engieeners"	(titel)
"Space Hulk: Ascension Edition"	(titel)
"Space Run"	(titel)
"Space Trader (Eigenproduktion)"	(titel)
"SpaceChem"	(titel)
"Spec Ops: The Line"	"Spec Ops: The Line"
"Speedrunners"	(titel)
"SpellForce 2: Demons of the Past"	"SpellForce 2: Demons of the Past"
"Spelunky"	Spelunky
"Spider Solitaire"	(titel)
"Spider-Man Unlimited"	(titel)
"Spin Tires"	(titel)
"Spintires"	(titel)
"Spirit Stones"	(titel)
"Spirits"	Spirits
"Splice"	(titel)
"Split Second: Velocity"	(titel)
"Spore"	Spore
"Star Citizen"	(titel)
"Star Conflict"	(titel)
"Star Made"	(titel)
"Star Ocean: The Last Hope"	"Star Ocean: The Last Hope"
"Star Pirates"	(titel)
"Star Trek Online"	"Star Trek Online"
"Star Trek: Starfleet Academy"	"Star Trek: Starfleet Academy"
"Star Wars: Battlefront II"	"Star Wars: Battlefront II"
"Star Wars: Commander"	(titel)
"Star Wars: Empire at War"	"Star Wars: Empire at War"
"Star Wars: Episode III – Die Rache der Sith"	(titel)
"Star Wars: Force Collection"	(titel)
"Star Wars: Jedi Knight 2: Jedi Outcast"	(titel)
"Star Wars Jedi Knight: Jedi Academy"	(titel)
"Star Wars: Knights of the Old Republic"	"Star Wars: Knights of the Old Republic"
"Star Wars: Knights of the Old Republic II - The Sith Lords"	"Star Wars: Knights of the Old Republic II - The Sith Lords"
"Star Wars: TIE Fighter"	"Star Wars: TIE Fighter"
"Star Wars: The Battle of Endor"	(titel)
"Star Wars: The Force Unleashed"	"Star Wars: The Force Unleashed"
"Star Wars: The Force Unleashed 2"	(titel)
"Star Wars: The Old Republic"	"Star Wars: The Old Republic"
"Star Wars: Tiny Death Star"	(titel)
"Star Wars: X-Wing"	"Star Wars: X-Wing"
"StarCraft II: Wings of Liberty"	"StarCraft II: Wings of Liberty"
"StarDrive"	(titel)
"Starbound"	(titel)
"Starcraft"	StarCraft
"Stargate: Resistance"	(titel)
"Starpoint Gemini"	"Starpoint Gemini"
"Starpoint Gemini 2"	(titel)
"Starwhal"	(titel)
"State of Decay"	"State of Decay"
"State of Decay: Breakdown"	"State of Decay: Breakdown"
"SteamWorld Dig"	"SteamWorld Dig"
"Steins;Gate"	(titel)
"Stick Hero"	(titel)
"Still Life 2"	"Still Life 2"
"Stonehearth"	(titel)
"Stonekeep"	Stonekeep
"Strategic Command Global Conflict"	(titel)
"Strategic Command World War 1"	(titel)
"Street Fighter Alpha 3"	"Street Fighter Alpha 3"
"Streetpass Mii-Lobby"	(titel)
"Strider"	Strider
"Stronghold"	Stronghold
"Stronghold Crusader"	(titel)
"Stronghold Crusader 2"	(titel)
"Stronghold Crusader HD"	(titel)
"Styx: Master of Shadows"	"Styx: Master of Shadows"
"Subway Surfer"	(titel)
"Subway Surfers"	(titel)
"Sudeki"	Sudeki
"Sudoku Free"	(titel)
"Suikoden"	Suikoden
"Summoners War: Sky Arena"	(titel)
"Sunless Sea"	(titel)
"Sunrider"	(titel)
"Sunset Overdrive"	(titel)
"Super Hexagon"	(titel)
"Super Mario 3D Land"	"Super Mario 3D Land"
"Super Mario 64"	"Super Mario 64"
"Super Mario Bros. 2"	"Super Mario Bros. 2"
"Super Mario Galaxy"	"Super Mario Galaxy"
"Super Mario World"	"Super Mario World"
"Super Meat Boy"	"Super Meat Boy"
"Super Smash  Bros  Wii U"	(titel)
"Super Smash Bros 4"	"Super Smash Bros 4"
"Super Smash Bros. Brawl"	"Super Smash Bros. Brawl"
"Super Smash Bros. Melee"	"Super Smash Bros. Melee"
"Super Street Fighter IV"	"Super Street Fighter IV"
"Super Street Fighter V"	(titel)
"Supersonic Acrobatic Rocket-Powered Battle-Cars"	"Supersonic Acrobatic Rocket-Powered Battle-Cars"
"Supreme Commander 2"	"Supreme Commander 2"
"Supreme Commander: Forged Alliance"	"Supreme Commander: Forged Alliance"
"Surgeon Simulator 2013"	(titel)
"Survarium"	(titel)
"Sword Art Online: Hollow Fragment"	"Sword Art Online: Hollow Fragment"
"Sword of the Stars: The Pit"	(titel)
"Symphony"	(titel)
"System Shock 2"	"System Shock 2"
"Söldner – Secret Wars"	(titel)
"TITAN  ATTACKS"	(titel)
"TOME: Immortal Arena"	(titel)
"TRI: Of Friendship and Madness"	(titel)
"Tactical Ops"	(titel)
"Take On Helicopters"	"Take on Helicopters"
"Tales Of Hearts"	(titel)
"Tales from the Borderlands"	(titel)
"Tales of Aravorn: Seasons Of The Wolf"	(titel)
"Tales of Innocence R"	"Tales of Innocence R"
"Tales of Phantasia"	"Tales of Phantasia"
"Tales of Symphonia"	"Tales of Symphonia"
"Tales of Symphonia: Dawn of the New World"	"Tales of Symphonia: Dawn of the New World"
"Tales of Xillia"	"Tales of Xillia"
"Tales of Xillia 2"	"Tales of Xillia 2"
"Tales of hearts r"	(titel)
"Tangled"	(titel)
"Team Fortress 2"	"Team Fortress 2"
"Team Fortress Classic"	"Team Fortress Classic"
"Teeworlds"	(titel)
"Tekken"	Tekken
"Tekken 6"	"Tekken 6"
"Tekken Tag Tournament"	"Tekken Tag Tournament"
"Tekken Tag Tournament 2"	"Tekken Tag Tournament 2"
"Teleglitch"	(titel)
"Teleglitch: Die More Edition"	(titel)
"Temple Run"	(titel)
"Temple Run 2"	(titel)
"Tera Online"	(titel)
"Terra Battle"	(titel)
"Terranigma"	Terranigma
"Terraria"	Terraria
"Tesla Effect: A Tex Murphy Adventure"	(titel)
"Tetris"	Tetris
"Tetris Ultimate"	(titel)
"Texas Hold'Em King 2"	(titel)
"The  Witcher 2"	(titel)
"The Age of Decadence"	(titel)
"The Amazing Spider-Man"	"The Amazing Spider-Man"
"The Amazing Spider-Man 2"	"The Amazing Spider-Man 2"
"The Banner Saga"	(titel)
"The Bard's Tale"	"The Bard's Tale"
"The Battle for Wesnoth"	(titel)
"The Binding of Isaac"	(titel)
"The Binding of Isaac: Rebirth"	"The Binding of Isaac: Rebirth"
"The Binding of Isaac. Rebirth"	(titel)
"The Blackwell Epiphany"	(titel)
"The Blackwell Legacy"	"The Blackwell Legacy"
"The Book of Unwritten Tales"	"The Book of Unwritten Tales"
"The Book of Unwritten Tales 2"	(titel)
"The Bridge"	(titel)
"The Cat Lady"	(titel)
"The Cave"	"The Cave"
"The Chronicles of Riddick: Escape from Butcher Bay"	"The Chronicles of Riddick: Escape from Butcher Bay"
"The Crew"	"The Crew"
"The Curious Expedition"	(titel)
"The Darkness II"	"The Darkness II"
"The Elder Scrolls III: Morrowind"	"The Elder Scrolls III: Morrowind"
"The Elder Scrolls IV: Oblivion"	"The Elder Scrolls IV: Oblivion"
"The Elder Scrolls Online"	"The Elder Scrolls Online"
"The Elder Scrolls V: Skyrim"	"The Elder Scrolls V: Skyrim"
"The Escapist"	(titel)
"The Evil Within"	"The Evil Within"
"The Expandabros"	(titel)
"The Forest"	(titel)
"The G.G. Shinobi"	(titel)
"The Golf Club"	"The Golf Club"
"The Hunter"	(titel)
"The Incredible Adventures of Van Helsing"	(titel)
"The Inner World"	(titel)
"The LEGO Movie Videogame"	"The LEGO Movie Videogame"
"The Last Of Us: Factions"	(titel)
"The Last Remnant"	"The Last Remnant"
"The Last Story"	"The Last Story"
"The Last Tinker: City of Colors"	(titel)
"The Last of Us"	"The Last of Us"
"The Last of Us: Remastered"	(titel)
"The Legend Of Zelda: Skyward Sword"	"The Legend Of Zelda: Skyward Sword"
"The Legend of Zelda: A Link between Worlds"	"The Legend of Zelda: A Link Between Worlds"
"The Legend of Zelda: A Link to the Past"	"The Legend of Zelda: A Link to the Past"
"The Legend of Zelda: Majora's Mask"	"The Legend of Zelda: Majora's Mask"
"The Legend of Zelda: Ocarina of Time"	"The Legend of Zelda: Ocarina of Time"
"The Legend of Zelda: Oracle of Ages"	"The Legend of Zelda: Oracle of Ages"
"The Legend of Zelda: Spirit Tracks"	"The Legend of Zelda: Spirit Tracks"
"The Legend of Zelda: The Wind Waker"	"The Legend of Zelda: The Wind Waker"
"The Legend of Zelda: Twilight Princess"	"The Legend of Zelda: Twilight Princess"
"The Long Dark"	(titel)
"The Longest Journey"	"The Longest Journey"
"The Lost Vikings"	"The Lost Vikings"
"The Masterplan"	(titel)
"The Night of the Rabbit"	(titel)
"The Organ Trail"	(titel)
"The Pinball Arcade"	"The Pinball Arcade"
"The Saboteur"	"The Saboteur"
"The Sailor's Dream"	(titel)
"The Samaritan Paradox"	(titel)
"The Second World"	"The Second World"
"The Secret World"	"The Secret World"
"The Secret of Monkey Island"	"The Secret of Monkey Island"
"The Secret of Monkey Island - Special Edition"	(titel)
"The Ship"	(titel)
"The Simpsons: Springfield"	(titel)
"The Simpsons: Tapped Out"	(titel)
"The Stanley Parable"	(titel)
"The Swapper"	"The Swapper"
"The Talos Principle"	(titel)
"The Third Age" Mod für Medieval II:Total War""	(titel)
"The Thirty-Nine Steps"	(titel)
"The Tiny Bang Story"	"The Tiny Bang Story"
"The Vanishing of Ethan Carter"	"The Vanishing of Ethan Carter"
"The Walking Dead"	(titel)
"The Witcher"	"The Witcher"
"The Witcher 2: Assassins of Kings"	"The Witcher 2: Assassins of Kings"
"The Witcher Adventure Game"	(titel)
"The Wolf Among Us"	(titel)
"The Wonderful 101"	"The Wonderful 101"
"The Yawhg"	(titel)
"TheHunter"	(titel)
"Theatrhythm Final Fantasy: Curtain Call"	(titel)
"Theme Hospital"	"Theme Hospital"
"Thief"	Thief
"Thief 4"	(titel)
"This War of Mine"	"This War of Mine"
"Threes!"	Threes!
"Time Ramesside"	(titel)
"Tiny Tower"	(titel)
"Tiny Troopers"	(titel)
"Tiny and Big: Grandpa's Leftovers"	(titel)
"Titan Attacks!"	"Titan Attacks!"
"Titan Quest"	"Titan Quest"
"Titanfall"	Titanfall
"To the Moon"	"To the Moon"
"Toki Tori"	"Toki Tori"
"Tom Clancy's Ghost Recon"	"Tom Clancy's Ghost Recon"
"Tom Clancy's Ghost Recon Advanced Warfighter"	(titel)
"Tom Clancy's Ghost Recon: Phantoms"	(titel)
"Tom Clancy's Rainbow Six: Rogue Spear"	"Tom Clancy's Rainbow Six: Rogue Spear"
"Tom Clancy's Splinter Cell: Blacklist"	"Tom Clancy's Splinter Cell: Blacklist"
"Tom Clancy's Splinter Cell: Conviction"	"Tom Clancy's Splinter Cell: Conviction"
"Tomb Raider"	"Tomb Raider"
"Tomb Raider 2"	"Tomb Raider 2"
"Tomb Raider: Anniversary"	"Tomb Raider: Anniversary"
"Tomb Raider: Definitive Edition"	"Tomb Raider: Definitive Edition"
"Tomb Raider: Underworld"	"Tomb Raider: Underworld"
"Tomodachi Life"	"Tomodachi Life"
"Tony Hawk's Pro Skater 3"	"Tony Hawk's Pro Skater 3"
"Tony Hawk's Pro Skater HD"	"Tony Hawk's Pro Skater HD"
"Tony Hawk's Underground 2"	"Tony Hawk's Underground 2"
"Top Eleven"	(titel)
"Torchlight"	Torchlight
"Torchlight II"	"Torchlight II"
"Total War Battles: Kingdom"	(titel)
"Total War: Rome II"	"Total War: Rome II"
"Total War: Shogun"	(titel)
"Total War: Shogun 2"	"Total War: Shogun 2"
"TowerFall Ascension"	(titel)
"Township"	(titel)
"Townsmen"	(titel)
"Toy Soldiers"	"Toy Soldiers"
"Toybox Turbos"	(titel)
"TrackMania"	TrackMania
"TrackMania 2"	(titel)
"TrackMania United"	"TrackMania United"
"Trackmania Nations"	"TrackMania Nations"
"Trackmania Nations Forever"	(titel)
"Traffic Racer"	(titel)
"Train Fever"	(titel)
"Train Simulator 2014"	(titel)
"Train Simulator 2015"	(titel)
"TransOcean: The Shipping Company"	(titel)
"Transformers: Fall of Cybertron"	"Transformers: Fall of Cybertron"
"Transistor"	Transistor
"Transport Tycoon"	"Transport Tycoon"
"Trials: Frontier"	(titel)
"Trials: Fusion"	"Trials: Fusion"
"Tribes: Ascend"	(titel)
"Trine"	Trine
"Trine 2"	"Trine 2"
"Triple Town"	(titel)
"Tron 2.0"	"TRON 2.0"
"Tropico"	Tropico
"Tropico 3"	"Tropico 3"
"Tropico 4"	"Tropico 4"
"Tropico 5"	(titel)
"Trove"	(titel)
"Turbo Dismount"	(titel)
"Turok 2: Seeds of Evil"	"Turok 2: Seeds of Evil"
"Two Worlds II"	"Two Worlds II"
"UFC Undisputed 3"	"UFC Undisputed 3"
"UFO: Enemy Unknown"	"UFO: Enemy Unknown"
"UFO: Extraterrestrials"	"UFO: Extraterrestrials"
"Ultima IV: Quest of the Avatar"	"Ultima IV: Quest of the Avatar"
"Ultima Online"	"Ultima Online"
"Ultimate NES Remix"	"Ultimate NES Remix"
"Ultra Street Fighter IV"	"Ultra Street Fighter IV"
"Uncharted 2: Among Thieves"	"Uncharted 2: Among Thieves"
"Uncharted 3"	(titel)
"Uncharted: Drakes Schicksal"	"Uncharted: Drakes Schicksal"
"Und mehr"	(titel)
"Underrail"	(titel)
"Underworld Empire"	(titel)
"Unholy Heights"	(titel)
"Universe Sandbox"	(titel)
"Uniwar"	(titel)
"Unmechanical"	(titel)
"Unreal"	Unreal
"Unreal Tournament 2003"	"Unreal Tournament 2003"
"Unreal Tournament 2004"	"Unreal Tournament 2004"
"Unturned"	(titel)
"Vagrant Story"	"Vagrant Story"
"Vainglory"	(titel)
"Valiant Hearts: The Great War"	"Valiant Hearts: The Great War"
"Valkyria Chronicles"	"Valkyria Chronicles"
"Vampire the Masquerade: Bloodlines"	(titel)
"Vector Thrust"	(titel)
"Velocity 2X"	"Velocity 2X"
"Velvet Assassin"	"Velvet Assassin"
"Verdun"	(titel)
"Victim of Xen"	(titel)
"Victoria II"	(titel)
"Vindictus"	(titel)
"Violett"	(titel)
"Virtua Tennis 4"	"Virtua Tennis 4"
"Virtue's Last Reward"	"Virtue's Last Reward"
"Viscera Cleanup Detail"	(titel)
"Volo Airsport"	(titel)
"Völgarr the Viking"	"Völgarr the Viking"
"WAKFU"	(titel)
"WET"	WET
"WRC 4 FIA World Rally Championship"	(titel)
"WRC: Powerslide"	(titel)
"WWE 2k13"	(titel)
"WWE 2k14"	"WWE 2K14"
"WWE 2k15"	"WWE 2K15"
"WWE Smackdown vs. Raw 2008"	(titel)
"War Thunder"	"War Thunder"
"War in the Pacific"	(titel)
"War of the Roses"	(titel)
"Warcraft III: Reign of Chaos"	"WarCraft III: Reign of Chaos"
"Warface"	Warface
"Warframe"	Warframe
"Wargame: Airland Battle"	"Wargame: AirLand Battle"
"Wargame: Red Dragon"	"Wargame: Red Dragon"
"Warhammer 40,000: Armageddon"	(titel)
"Warhammer 40,000: Dawn of War"	"Warhammer 40,000: Dawn of War"
"Warhammer 40,000: Dawn of War II"	"Warhammer 40,000: Dawn of War II"
"Warhammer 40,000: Space Marine"	"Warhammer 40,000: Space Marine"
"Warhammer: Mark of Chaos"	"Warhammer: Mark of Chaos"
"Wario Ware, Inc. Minigame Mania"	"Wario Ware, Inc. Minigame Mania"
"Warlock: Master of Arcane"	(titel)
"Warlords: Battlecry III"	"Warlords: Battlecry III"
"Warmachine: Tactics"	(titel)
"Warzone 2100"	"Warzone 2100"
"Wasteland   2"	(titel)
"Wasteland 2"	(titel)
"Watch_Dogs"	Watch_Dogs
"Way of the Samurai 4"	"Way of the Samurai 4"
"Wii Fit U"	"Wii Fit U"
"Wii Party U"	"Wii Party U"
"WildStar"	(titel)
"Wimmelbildspiele (Big Fish)"	(titel)
"Wing Commander III: Heart of the Tiger"	"Wing Commander III: Heart of the Tiger"
"Wings of Vi"	(titel)
"Wizardry: Crusaders of the Dark Savant"	"Wizardry: Crusaders of the Dark Savant"
"Wizard's Choice"	(titel)
"Wolfenstein"	Wolfenstein
"Wolfenstein: Enemy Territory"	"Wolfenstein: Enemy Territory"
"Wolfenstein: The New Order"	"Wolfenstein: The New Order"
"World  of Warcraft"	(titel)
"World Cruise Story"	(titel)
"World In Conflict"	"World in Conflict"
"World Soccer Winning Eleven 9"	"World Soccer Winning Eleven 9"
"World War II Online"	(titel)
"World in Conflict"	"World in Conflict"
"World of  Warcraft"	(titel)
"World of Guns: Gun Disassembly"	(titel)
"World of Tanks"	"World of Tanks"
"World of Warcraft"	"World of WarCraft"
"World of Warplanes"	"World of Warplanes"
"Worms"	Worms
"Worms 2: Armageddon"	"Worms 2: Armageddon"
"Worms Armageddon"	"Worms Armageddon"
"Worms: Battlegrounds"	"Worms: Battlegrounds"
"Worms: Clan Wars"	"Worms: Clan Wars"
"Worms: Reloaded"	(titel)
"Worms: Revolution"	"Worms: Revolution"
"Worms: Ultimate Mayhem"	"Worms: Ultimate Mayhem"
"X: Beyond The Frontier"	"X: Beyond the Frontier"
"X: Rebirth"	"X: Rebirth"
"X: Superbox"	(titel)
"X3: Albion Prelude"	(titel)
"X3: Gold Edition"	(titel)
"X3: Terran Conflict"	(titel)
"XCOM: Enemy Unknown"	"XCOM: Enemy Unknown"
"XCOM: Enemy Within"	"XCOM: Enemy Within"
"X-COM: Terror from the Deep"	"X-COM: Terror from the Deep"
"XCOM UFO Defense"	(titel)
"XIII"	XIII
"X-Plane 10"	(titel)
"XStoryPlayer 3.0"	(titel)
"Xenonauts"	(titel)
"YGOPro DevPro"	(titel)
"Yakuza 4"	"Yakuza 4"
"Yoshi's Story"	"Yoshi's Story"
"Ys Origin"	"Ys Origin"
"Yu-Gi-Oh! Worldwide Edition: Stairway to the Destined Duel"	"Yu-Gi-Oh! Worldwide Edition: Stairway to the Destined Duel"
"Z"	Z
"Zengrams"	(titel)
"Zombie Driver HD"	"Zombie Driver HD"
"Zombie Roadkill"	(titel)
"Zombies vs. Plants"	(titel)
"Zoo Tycoon"	"Zoo Tycoon"
"Zug um Zug"	(titel)
"der herr der ringe  schlacht um mittelerde"	(titel)
"diablo  3"	(titel)
"forza horizon  2"	(titel)
"guitar hero 6"	(titel)
"iRacing.com"	(titel)
"inFAMOUS Second Son"	(titel)
"inFamous 2"	"inFamous 2"
"mushroom garden"	(titel)
"prey"	(titel)
"rFactor"	rFactor
"salt"	(titel)
"skate 3"	"skate 3"
"the  crew"	(titel)
"the evil  within"	(titel)
"the walking  dead telltall"	(titel)
"this  war of  mine"	(titel)
